SO ./assets/door.xpm
NO ./assets/door.xpm
WE ./assets/door.xpm
EA ./assets/door.xpm
F 198,006,85
C 000,160,90


111111111111111111111111111111111111111
1E0000000000000000000000000000000000001
1111111111111111111111111111111111111111111111111111111111111111111111111111
                                      1
                                      1
                                      1
                                      1
                                      1
                                      1
                                      1
                                      1
                                      1
                                      1
                                      1
                                      1
                                      1
                                      1
                                      1
                                      1
                                      1
                                      1
                                      1
                                      1
