SO ./assets/door.xpm
NO ./assets/nbar.xpm
WE ./assets/pong.xpm
EA ./assets/quit.xpm
F 198,006,85
C 000,160,90

11111111111111111111111111111111111111
                           11111011111
                           11100N00111
                           11111011111
                                1
    11111111111111111111111111
    10000000001100000000000001
    101000000111000000000000001
    100000000000000000000000001
11111100001100000110100000000011111
10000000001100000000000000101111111
11110111111111000000000010001
11110111111111000000000010001
11000000110101000000000010001
10000000000000000000000010001
10000000000000000001010010001
1100000111010101111101111000111
11110111 1110101 101111010001
11111111 1111111 111111111111