NO ./assets/N1.xpm
SO ./assets/S1.xpm
F 255,0,0
WE ./assets/W1.xpm
EA ./assets/E1.xpm
C 0,255,0




        111111111111111111111111111
	1000000 000110 000000000001
	101100000111 000 0000000001
	100100000000 0000 000000001
1111111110110000011 100 00000000001
10000000001100000111011  1111011111
11110111111111011100000010001
11110111111111011101010010001
11000000110101011100000010001
100S0000000000001100000010001
10000000000000001101010010001
1100000111010101111101111000111
11110111 1110101 101111010001
11111111 1111111 111111111111
