NO ./assets/N1.xpm

SO ./assets/S1.xpm

WE ./assets/W1.xpm

EA ./assets/E1.xpm

F 255,0,0
C 0,255,0

1111111111
1000000001
1000000001
1000S00001
1000000001
1000000001
1111111111