SO ./assets/door.xpm
NO ./assets/door.xpm
WE ./assets/door.xpm
EA ./assets/door.xpm
F 124,000,124
C 250,10,090

111111111111111
111110000000001
111110111111101
111110111111101
111110111111101
100000000000101
10000N000000101
100000000000101
111110111111101
111100000000001
111111111111111